10.ox
..........
.o........
.........o
........o.
....ooo...
..........
.........o
..........
..........
.o........
